10 10
.f......a.
...f..f...
af........
......b...
..........
.......f..
..........
........h.
..........
s.........
